################################################################################
================================================================================
################################################################################
================================================================================
################################################################################
================================================================================
                                                                                
================================================================================
                                                                                
================================================================================
                                                                                
================================================================================
                                                                                
================================================================================
                                                                                
================================================================================
                                                                                
================================================================================
                                                                                
================================================================================
                                                                                
================================================================================
E                                                                         I     
================================================================================
                                                                                
