                             I                                                  
                                                                                
                                                                                
                 ##                          ##                                 
                ####                        ####                                
                ####         ####           ####                                
                 ##           ##             ##                                 
                 ##-----------##-------------##                                 
                 ##         £ ## £           ##       ###                       
                 ##-----------##-------------############                       
                 ## £         ##           £ ##       ###                       
                 ##-----------##--------#######        @                        
                 ##                          ##        @                        
                 ##         "#####           ##        @                        
                 ##                                    @                        
                 ##                                    @       e                
                 ##                          #####~##############               
                 ##                         ###                                 
                 ##                        ####                                 
                 ##                       #####                                 
                 ##                      ######                                 
                ####         ####T      ########                                
                ####                        ####                                
                 ##                          ##                                 
                                                                                
