 °     °     °     ° °      £    °    °            °                            
???°??£°°???£°????£???? /7 {°1            °          °    1        By##Goemie###
?°??? ?°*°? ?° ?? ?°?° /???\   °}    ° °££  °   °        /?\    °           -   
???° ???°? ???°? ????£/??)??\ 1 °° °    /\       11° 11 /???\           11      
??* ????° ????° ???? /???????\    °    /  \   ° 1   °  /%%?%%\    °    1  °11   
°? 1????£1????£1????1%%%%??%%%1  °    1    \     °1   ££££%££££       °         
??*   ]°°   ]°°   }######?(#####    °?%%%%%%1      ° ######~###1   °   1      ° 
?° ????°???????°? #######?#######   ########%#  °   ########### #       1       
??°   }? ??°???? ########??####### ############    ############ ##     °     #  
?? ??°  ?°????  #########)?######## ############  ############# ###   1     ### 
?°?   }?????? ############?######### ########### ############## ####   1   #####
?? °????°??? ###########???########## ######### ############### ####    ° %#####
? °??°????? ############ ((########### ####### ####(---  ###### ### ##   #######
£???????°? #    £ ££££}?1 ############# ##### ####(- # #- #### -#  #### ########
? ?°??°??   #)#£#£##£###)  ############# ### ######(- ##£-£ # -  --### # #######
?? ????? ################) ############## # ########(- ##£)  -##-# ## ### ######
?°-?°?? ################## ############### ###########-)###--#####-# ##### #####
?? ??? ##################  ################ ########## -)###-##### £####### ####
°?? ? ################### (################# ######## -)#################### ###
???? #################### ################### ###### -)###################### ##
? ? #####################  ################### # ##@-)######################## #
?? ######################) #################### ##I-)########################## 
#I#                                            # ###############################
##########################3#####################################################
                                                                                
