################################################################################
#   #       #]   #@         #    #                                              
#I          ####@#@         #    #                                              
#####             @         #    #                                              
]   @             @              #                                              
#####~####################--######                             #                
                                 #                            ###               
"#################################                           #####              
  #         £#   #   #   #   #££ #                          #     #             
  #        ###  ]#]  #]  # ] ### #                          #     #             
  #           ################   #                          #                   
                           {     #                           # ###              
-#########"#####################"#                           #   #\             
  #    #  # #    #    #    #    ##                           #"# # \            
" #    #    #    #    #    #     #                           #   #  \           
  #  ] #]   #  ] #   ]# ]  #   ] #                           #   #   \          
  ###############################                            # #"#    \         
  #    #    #    #    #    #     #                           #   #     \        
  # ]  #]   #   ]# ]  #  ] #]    #                           #   #      \       
  ################################         ##                #"# #       \      
                                          # £#                   #        \e    
 ########################################## ####################"###############
                                                                          #     
           [   [   [   [   [   [  [   [  [ [ [ [  [                       #     
###"##########"#########"########"#########"#######"#######"#######"#####"######
